$$$ exec p2 : [./jcamhi.filler]
Plateau 15 17:
    01234567890123456
000 .................
001 .................
002 .................
003 .................
004 .................
005 OO...............
006 OOOO.............
007 .OO..............
008 .OO..............
009 .................
010 .................
011 ..........X......
012 ..........XXXXX..
013 .................
014 .................
Piece 1 3:
**.
